10 10
1001111111
1010101011
1000101001
1010000001
1011111101
1000100101
1110110101
1000000101
1111110101
1000000001